static const aboutButtonSvg = 'assets/svgs/about_button.svg';
static const accountSvg = 'assets/svgs/account.svg';
static const accountSeletedSvg = 'assets/svgs/account_seleted.svg';
static const arrowBackSvg = 'assets/svgs/arrow_back.svg';
static const arrowDownSvg = 'assets/svgs/arrow_down.svg';
static const arrowEnterSvg = 'assets/svgs/arrow_enter.svg';
static const articleSvg = 'assets/svgs/article.svg';
static const backgroundEffectSvg = 'assets/svgs/background_effect.svg';
static const commentSvg = 'assets/svgs/comment.svg';
static const copySvg = 'assets/svgs/copy.svg';
static const deleteSvg = 'assets/svgs/delete.svg';
static const dialogSvg = 'assets/svgs/dialog.svg';
static const dietSvg = 'assets/svgs/diet.svg';
static const drugSvg = 'assets/svgs/drug.svg';
static const editSvg = 'assets/svgs/edit.svg';
static const excretionSvg = 'assets/svgs/excretion.svg';
static const femaleSvg = 'assets/svgs/female.svg';
static const filterSvg = 'assets/svgs/filter.svg';
static const findPlaceSvg = 'assets/svgs/find_place.svg';
static const findPlaceSeletedSvg = 'assets/svgs/find_place_seleted.svg';
static const homeSvg = 'assets/svgs/home.svg';
static const homeSeletedSvg = 'assets/svgs/home_seleted.svg';
static const loadLogoSvg = 'assets/svgs/load_logo.svg';
static const loginLogoSvg = 'assets/svgs/login_logo.svg';
static const logoutButtonSvg = 'assets/svgs/logout_button.svg';
static const maleSvg = 'assets/svgs/male.svg';
static const managementSvg = 'assets/svgs/management.svg';
static const mapSvg = 'assets/svgs/map.svg';
static const medicalSvg = 'assets/svgs/medical.svg';
static const menuSvg = 'assets/svgs/menu.svg';
static const notificationSvg = 'assets/svgs/notification.svg';
static const notificationButtonSvg = 'assets/svgs/notification_button.svg';
static const optionSvg = 'assets/svgs/option.svg';
static const passwordHideSvg = 'assets/svgs/password_hide.svg';
static const passwordShowSvg = 'assets/svgs/password_show.svg';
static const profileButtonSvg = 'assets/svgs/profile_button.svg';
static const sendSvg = 'assets/svgs/send.svg';
static const socialSvg = 'assets/svgs/social.svg';
static const socialSeletedSvg = 'assets/svgs/social_seleted.svg';
static const starSvg = 'assets/svgs/star.svg';
static const vaccineSvg = 'assets/svgs/vaccine.svg';
